AutomaticOctopusConfigSandbox	Automation
//Automation.Engineering	Automation
//Automation.ITOps	Automation
//Automation.Marketing	Automation
//BuildProcess.StandardNuGet	Automation
//ConsoleTweet	Automation
//DeploymentProcess.BuildTools	Automation
//DeploymentProcess.DeploymentTools	Automation
//DeploymentProcess.InternalMyGet	Automation
//DeploymentProcess.OperationsContracts	Automation
//DeploymentProcess.StandardNuGet	Automation
//DeploymentSandbox	Automation
//GitHubReleaseNotes	Automation
//mmbot	Automation
//NuGetPackager	Automation
//OctopusConfigUpdater	Automation
//OctopusProjectUpdater	Automation
//OctopusWrapper	Automation
//PBot	Automation
//PBot.TestRepo	Automation
//RepoStandards	Automation
//SyncOMatic	Automation
//SyncOMatic.TestRepository	Automation
//TeamCityProjectCreator	Automation
//Timestamp	Automation
//docs.particular.net	Docs
//HandsOnLabs	Docs
//NServiceBus	NServiceBus
//NServiceBus.Azure	NServiceBus
//NServiceBus.Bootstrap.WindowsService	NServiceBus
//NServiceBus.Callbacks	NServiceBus
//NServiceBus.CommonLogging	NServiceBus
//NServiceBus.Distributor.Msmq	NServiceBus
//NServiceBus.Gateway	NServiceBus
//NServiceBus.Host	NServiceBus
//NServiceBus.Host.AzureCloudService	NServiceBus
//NServiceBus.Log4Net	NServiceBus
//NServiceBus.Newtonsoft.Json	NServiceBus
//NServiceBus.NLog	NServiceBus
//NServiceBus.Testing	NServiceBus
//Topshelf	NServiceBus
//NServiceBus.Autofac	NServiceBus.Container
//NServiceBus.CastleWindsor	NServiceBus.Container
//NServiceBus.Ninject	NServiceBus.Container
//NServiceBus.Spring	NServiceBus.Container
//NServiceBus.StructureMap	NServiceBus.Container
//NServiceBus.Unity	NServiceBus.Container
//NServiceBus.AzureStoragePersistence	NServiceBus.Persistence
//NServiceBus.NHibernate	NServiceBus.Persistence
//NServiceBus.RavenDB	NServiceBus.Persistence
//NServiceBus.ServiceFabric	NServiceBus.Persistence
//NServiceBus.Azure.Samples	NServiceBus.Transport
//NServiceBus.AzureBlobStorageDataBus	NServiceBus.Transport
//NServiceBus.AzureServiceBus	NServiceBus.Transport
//NServiceBus.AzureStorageQueues	NServiceBus.Transport
//NServiceBus.RabbitMQ	NServiceBus.Transport
//NServiceBus.SqlServer	NServiceBus.Transport
//InstallerCustomActions	PlatformInstaller
//NServiceBus.PowerShell	PlatformInstaller
//Packages.DTC	PlatformInstaller
//Packages.Msmq	PlatformInstaller
//Packages.PerfCounters	PlatformInstaller
//PlatformInstaller	PlatformInstaller
//ServiceControl	ServiceControl
//ServiceControl.Contracts	ServiceControl
//ServiceControl.Plugin.Nsb3.CustomChecks	ServiceControl
//ServiceControl.Plugin.Nsb3.Heartbeat	ServiceControl
//ServiceControl.Plugin.Nsb4.CustomChecks	ServiceControl
//ServiceControl.Plugin.Nsb4.DebugSession	ServiceControl
//ServiceControl.Plugin.Nsb4.Heartbeat	ServiceControl
//ServiceControl.Plugin.Nsb4.SagaAudit	ServiceControl
//ServiceControl.Plugin.Nsb5.CustomChecks	ServiceControl
//ServiceControl.Plugin.Nsb5.DebugSession	ServiceControl
//ServiceControl.Plugin.Nsb5.Heartbeat	ServiceControl
//ServiceControl.Plugin.Nsb5.SagaAudit	ServiceControl
//ServiceControl.Plugins.v4	ServiceControl
//ServiceControl.Plugins.v5	ServiceControl
//ServiceInsight	ServiceInsight
//ServiceMatrix	ServiceMatrix
//ServiceMatrix.Samples	ServiceMatrix
//SignVSIX	ServiceMatrix
//ServicePulse	ServicePulse
